13   15
PIIIIIIBIIIIIIP
IXBXBXBXBXBXBXI
IBBBBBBBBBBBBBI
IXBXBXBXBXBXBXI
IBBBBBBBBBBBBBI
IXBXBXBXBXBXBXI
BBBBBBBBBBBBBBB
IXBXBXBXBXBXBXI
IBBBBBBBBBBBBBI
IXBXBXBXBXBXBXI
IBBBBBBBBBBBBBI
IXBXBXBXBXBXBXI
PIIIIIIBIIIIIIP
