13  15
BBBBOOOBOOOBBBB
BTBOYYYOYYYOBTB
BBOYOBOYOBOYOBB
BOYOBBBBBBBOYOB
BOYBBBBBBBBBYOB
BPYOBBBBBBBOYPB
BOYBBBXXXBBBYOB
BBOYOBBBBBOYOBB
BBBOYBBBBBOYOBB
BBBBOYOBOYOBBBB
BBOBBOYYYOBBOBB
BTOBBBOOOBBBOTB
BOPBBBBBBBBBPOB

